
乘	乗
亂	乱
亙	亘
亞	亜
佛	仏
來	来
假	仮
傳	伝
僞	偽
價	価
儉	倹
兒	児
內	内
兩	両
剩	剰
劍	剣
劑	剤
勞	労
勳	勲
勵	励
勸	勧
區	区
卷	巻
卻	却
參	参
咒	呪
啞	唖
單	単
噓	嘘
嚙	噛
嚴	厳
囑	嘱
圈	圏
國	国
圍	囲
圓	円
圖	図
團	団
增	増
墮	堕
壓	圧
壘	塁
壞	壊
壤	壌
壯	壮
壹	壱
壽	寿
奧	奥
奬	奨
妝	粧
孃	嬢
學	学
寢	寝
實	実
寫	写
寬	寛
寶	宝
將	将
專	専
對	対
屆	届
屬	属
峯	峰
峽	峡
嶽	岳