㓦划	㓦劃
一丝不挂	一絲不掛
一了心愿	一了心願
一了百了	一了百了
一了百当	一了百當
一争两丑	一爭兩醜
一伙	一夥
一伙人	一夥人
一伙头	一夥頭
一偿宿愿	一償宿願
一元复始	一元復始
一克	一克
一党	一黨
一冲性子	一沖性子
一准	一準
一出剧	一齣劇
一出去	一出去
一出场	一出場
一出子	一齣子
一出戏	一齣戲
一出来	一出來
一出生	一出生
一出祁山	一出祁山
一分收获	一分收穫
一分耕耘	一分耕耘
一分钟	一分鐘
一划	一劃
一别	一別
一别多年	一別多年
一别头	一彆頭
一刻千金	一刻千金
一前一后	一前一後
一力承当	一力承當
一卷	一卷
一厘一毫	一釐一毫
一厢情愿	一廂情願
一去不回	一去不回
一去不复	一去不復
一去不复返	一去不復返
一发	一發
一发之差	一髮之差
一发之间	一髮之間
一发千钧	一髮千鈞
一口钟	一口鐘
一只	一隻
一台	一臺
一台台	一臺臺
一叶	一葉
一叶兰	一葉蘭
一叶扁舟	一葉扁舟
一叶知秋	一葉知秋
一号木杆	一號木桿
一吊	一吊
一吊钱	一吊錢
一同	一同
一向	一向
一周	一週
一周天	一周天
一周年	一週年
一周遭	一周遭
一哄	一鬨
一哄而上	一哄而上
一哄而散	一鬨而散
一哄而起	一哄而起
一哄而集	一哄而集
一喊出	一喊出
一回	一回
一回事	一回事
一团	一團
一团和气	一團和氣
一团团	一團團
一团漆黑	一團漆黑
一团火	一團火
一团糟	一團糟
一国两制	一國兩制
一地胡拿	一地胡拿
一地里	一地裏
一块面	一塊麪
一坛	一罈
一坛坛	一罈罈
一坛死水	一壇死水
一塌糊涂	一塌糊塗
一壶千金	一壺千金
一夜致富	一夜致富
一大伙	一大夥
一天后	一天後
一天星斗	一天星斗
一天钟	一天鐘
一夫一妻	一夫一妻
一夫当关	一夫當關
一妻制	一妻制
一妻多夫	一妻多夫
一孔出气	一孔出氣
一字一板	一字一板
一字千金	一字千金
一寸秋波	一寸秋波
一将功成	一將功成
一展长才	一展長才
一干	一干
一干二净	一乾二淨
一干人	一干人
一干家中	一干家中
一干弟兄	一干弟兄
一干弟子	一干弟子
一干而尽	一乾而盡
一干部下	一干部下
一并	一併
一开出来	一開出來
一弦	一弦
一当	一當
一心向上	一心向上
一念	一念
一念三千	一念三千
一扎	一紮
一托头	一托頭
一托气	一托氣
一扣	一扣
一折	一折
一折一磨	一折一磨
一折两段	一折兩段
一折八扣	一折八扣
一拍即合	一拍即合
一挂	一掛
一挂之下	一掛之下
一掷千金	一擲千金
一掷百万	一擲百萬
一搜	一搜
一摇一摆	一搖一擺
一摇三摆	一搖三擺
一播出	一播出
一斗	一斗
一斗再斗	一鬥再鬥
一斗斗	一斗斗
一方面	一方面
一无所获	一無所獲
一日万机	一日萬機
一日三秋	一日三秋
一日千里	一日千里
一日叫娘	一日叫孃
一早起了	一早起了
一时糊涂	一時糊塗
一曲	一曲
一曲千金	一曲千金
一曲阳关	一曲陽關
一本万利	一本萬利
一杆	一杆
一杆进洞	一桿進洞
一杠	一槓
一杯	一杯
一杯杯	一杯杯
一杯羹	一杯羹
一松	一鬆
一板	一板
一板一眼	一板一眼
一板三眼	一板三眼
一柜	一櫃
一树百获	一樹百穫
一根烟	一根菸
一死了之	一死了之
一毫一发	一毫一髮
一池秋水	一池秋水
一沐三捉发	一沐三捉髮
一沐三握发	一沐三握髮
一波三折	一波三折
一泻千里	一瀉千里
一派胡言	一派胡言
一流人才	一流人才
一涂	一塗
一游	一遊
一溜烟	一溜煙
一点钟	一點鐘
一物一制	一物一制
一物克一物	一物剋一物
一百多万	一百多萬
一百廿万	一百廿萬
一目了然	一目瞭然
一相情愿	一相情願
一看出	一看出
一碗面	一碗麪
一碧万顷	一碧萬頃
一禾九穗	一禾九穗
一种	一種
一秒钟	一秒鐘
一穗三秀	一穗三秀
一笑了之	一笑了之
一笑千金	一笑千金
一笔划	一筆劃
一答一合	一答一合
一签	一簽
一箭之仇	一箭之仇
一箭双雕	一箭雙鵰
一系	一系
一系列	一系列
一统志	一統志
一网打尽	一網打盡
一翻出	一翻出
一胎制	一胎制
一至于此	一至於此
一致	一致
一致字	一致字
一致性	一致性
一致百虑	一致百慮
一般等价	一般等價
一落千丈	一落千丈
一表	一表
一表人才	一表人才
一表人材	一表人材
一表人物	一表人物
一表非俗	一表非俗
一表非凡	一表非凡
一见钟情	一見鍾情
一见面	一見面
一视同仁	一視同仁
一览表	一覽表
一触即发	一觸即發
一言不发	一言不發
一言不合	一言不合
一言千金	一言千金
一言已定千金不移	一言已定千金不移
一言既出	一言既出
一言既出驷马难追	一言既出駟馬難追
一言难尽	一言難盡
一讲出	一講出
一语不发	一語不發
一说出	一說出
一诺值千金	一諾值千金
一诺千金	一諾千金
一败涂地	一敗塗地
一赞	一讚
一走了之	一走了之
一起干	一起幹
一蹴可几	一蹴可幾
一身作事一身当	一身作事一身當
一轨同风	一軌同風
一辞莫赞	一辭莫贊
一递里	一遞裏
一逞兽欲	一逞獸慾
一道烟	一道煙
一醉解千愁	一醉解千愁
一里	一里
一里一外	一裏一外
一针	一針
一针见血	一針見血
一锅面	一鍋麪
一锹掘个井	一鍬掘個井
一院制	一院制
一雨成秋	一雨成秋
一面	一面
一面之交	一面之交
一面之缘	一面之緣
一面之识	一面之識
一面之词	一面之詞
一面之辞	一面之辭
一面之雅	一面之雅
一面倒	一面倒
一面儿官司	一面兒官司
一面如旧	一面如舊
一面点	一面點
一飞冲天	一飛沖天
一食万钱	一食萬錢
一饭千金	一飯千金
一饮而尽	一飲而盡
一马当先	一馬當先
一麾出守	一麾出守
一鼓一板	一鼓一板
一鼻孔出气	一鼻孔出氣
一龙生九种种种各别	一龍生九種種種各別
丁一确二	丁一確二
丁丁冬冬	丁丁冬冬
丁丁当当	丁丁當當
丁丁炒面	丁丁炒面
丁丑	丁丑
丁伯升	丁伯升
丁克	丁克
丁冬	丁冬
丁固生松	丁固生松
丁娘十索	丁娘十索
丁字梁	丁字梁
丁当	丁當
丁柏升	丁柏升
丁种	丁種
丁种维生素	丁種維生素
丁铃当啷	丁鈴噹啷
丁零当啷	丁零當啷
丁鸿志	丁鴻志
七万	七萬
七万三千	七萬三千
七万五千	七萬五千
七万八千	七萬八千
七万六千	七萬六千
七万四千	七萬四千
七个	七個
七个八个	七個八個
七了八当	七了八當
七余	七餘
七八下里	七八下裏
七出	七出
七出祁山	七出祁山
七分钟	七分鐘
七划	七劃
七十七万	七十七萬
七十七国集团	七十七國集團
七十五万	七十五萬
七千	七千
七千两百	七千兩百
七发	七發
七只	七隻
七台	七臺
七台河	七臺河
七台河市	七臺河市
七叶胆	七葉膽
七周	七週
七回	七回
七团	七團
七国集团	七國集團
七坛	七罈
七天后	七天後
七娘	七娘
七娘妈	七孃媽
七孔生烟	七孔生煙
七巧板	七巧板
七弦	七絃
七彩	七彩
七彩缤纷	七彩繽紛
七彩虹	七彩虹
七情六欲	七情六慾
七扎	七紮
七折	七折
七折八扣	七折八扣
七政四余	七政四餘
七星坛	七星壇
七星岩	七星巖
七星板	七星板
七星瓢虫	七星瓢蟲
七杯	七杯
七步之才	七步之才
七步奇才	七步奇才
七点钟	七點鐘
七百万	七百萬
七百多万	七百多萬
七种	七種
七秒钟	七秒鐘
七窍冒烟	七竅冒煙
七窍生烟	七竅生煙
七色板	七色板
七里河	七里河
七里河区	七里河區
七里香	七里香
万一	萬一
万一只	萬一只
万万	萬萬
万万不可	萬萬不可
万万千千	萬萬千千
万万岁	萬萬歲
万丈	萬丈
万丈光芒	萬丈光芒
万丈深渊	萬丈深淵
万丈竿头	萬丈竿頭
万丈红尘	萬丈紅塵
万丈高楼平地起	萬丈高樓平地起
万不及一	萬不及一
万不可失	萬不可失
万不失一	萬不失一
万不得已	萬不得已
万世	萬世
万世一时	萬世一時
万世师表	萬世師表
万个	萬個
万丰	萬豐
万丹	萬丹
万丹乡	萬丹鄉
万乘	萬乘
万乘之国	萬乘之國
万乘之尊	萬乘之尊
万事	萬事
万事亨通	萬事亨通
万事俱备只欠东风	萬事俱備只欠東風
万事具备	萬事具備
万事大吉	萬事大吉
万事如意	萬事如意
万事得	萬事得
万事皆从急中错	萬事皆從急中錯
万事皆休	萬事皆休
万事皆备	萬事皆備
万事起头难	萬事起頭難
万事达	萬事達
万事达卡	萬事達卡
万事通	萬事通
万人	萬人
万人之敌	萬人之敵
万人之敵	萬人之敵
万人坑	萬人坑
万人敌	萬人敵
万人空巷	萬人空巷
万人迷	萬人迷
万仞	萬仞
万代	萬代
万代一时	萬代一時
万代兰	萬代蘭
万代千秋	萬代千秋
万份	萬份
万众	萬衆
万众一心	萬衆一心
万众欢腾	萬衆歡騰
万众瞩目	萬衆矚目
万位	萬位
万余	萬餘
万余只	萬餘隻
万余里	萬餘里
万俟	万俟
万倍	萬倍
万儿	萬兒
万儿八千	萬兒八千
万元	萬元
万元户	萬元戶
万全	萬全
万全之策	萬全之策
万全之计	萬全之計
万全县	萬全縣
万全街	萬全街
万兽之王	萬獸之王
万几	萬幾
万分	萬分
万分之一	萬分之一
万分感激	萬分感激
万分痛苦	萬分痛苦
万别千差	萬別千差
万剐千刀	萬剮千刀
万劫	萬劫
万劫不复	萬劫不復
万千	萬千
万华	萬華
万华区	萬華區
万华站	萬華站
万博宣伟	萬博宣偉
万博省	萬博省
万卷	萬卷
万卷书	萬卷書
万历	萬曆
万县	萬縣
万县地区	萬縣地區
万县市	萬縣市
万县港	萬縣港
万变不离其宗	萬變不離其宗
万古	萬古
万古不灭	萬古不滅
万古千秋	萬古千秋
万古流芳	萬古流芳
万古留芳	萬古留芳
万古长新	萬古長新
万古长春	萬古長春
万古长青	萬古長青
万只	萬隻
万叶	萬葉
万名	萬名
万向节	萬向節
万国	萬國
万国公报	萬國公報
万国公法	萬國公法
万国宫	萬國宮
万国旗	萬國旗
万国码	萬國碼
万国邮联	萬國郵聯
万国音标	萬國音標
万圆	萬圓
万圣节	萬聖節
万坛	萬罈
万境归空	萬境歸空
万壑	萬壑
万壑争流	萬壑爭流
万天后	萬天後
万夫	萬夫
万夫不当	萬夫不當
万夫莫当	萬夫莫當
万夫莫敌	萬夫莫敵
万头攒动	萬頭攢動
万姓	萬姓
万姓统谱	萬姓統譜
万字	萬字
万宁市	萬寧市
万安	萬安
万安县	萬安縣
万宝华	萬寶華
万宝囊	萬寶囊
万宝常	萬寶常
万宝路	萬寶路
万家	萬家
万家乐	萬家樂
万家灯火	萬家燈火
万家生佛	萬家生佛
万家香	萬家香
万寿	萬壽
万寿千秋	萬壽千秋
万寿山	萬壽山
万寿无疆	萬壽無疆
万寿果	萬壽果
万寿菊	萬壽菊
万山	萬山
万山特区	萬山特區
万山镇	萬山鎮
万岁	萬歲
万岁千秋	萬歲千秋
万岁爷	萬歲爺
万峦	萬巒
万峦乡	萬巒鄉
万州区	萬州區
万年	萬年
万年历	萬年曆
万年历表	萬年曆錶
万年县	萬年縣
万年青	萬年青
万幸	萬幸
万念	萬念
万念俱灰	萬念俱灰
万急	萬急
万恩市	萬恩市
万恶	萬惡
万恶之源	萬惡之源
万恶之首	萬惡之首
万恶淫为首	萬惡淫爲首
万恶滔天	萬惡滔天
万户	萬戶
万户侯	萬戶侯
万户千门	萬戶千門
万扎	萬紮
万把	萬把
万把块	萬把塊
万斛泉源	萬斛泉源
万斤	萬斤
万斯同	萬斯同
万方	萬方
万旗	万旗
万无	萬無
万无一失	萬無一失
万无失一	萬無失一
万智牌	萬智牌
万有	萬有
万有引力	萬有引力
万有引力定律	萬有引力定律
万望	萬望
万机	萬機
万杞良	萬杞良
万柏林	萬柏林
万柏林区	萬柏林區
万桶	萬桶
万步	萬步
万步表	萬步表
万死	萬死
万死一生	萬死一生
万死不辞	萬死不辭
万段	萬段
万毒枯	萬毒枯
万民伞	萬民傘
万水千山	萬水千山
万沙浪	萬沙浪
万泉河	萬泉河
万法唯识	萬法唯識
万泰银	萬泰銀
万洋山	萬洋山
万源市	萬源市
万灵丹	萬靈丹
万灵节	萬靈節
万灵药	萬靈藥
万点	萬點
万点大关	萬點大關
万物	萬物
万物之灵	萬物之靈
万状	萬狀
万用	萬用
万用字元	萬用字元
万用手冊	萬用手冊
万用电表	萬用電表
万用表	萬用表
万盛	萬盛
万盛区	萬盛區
万盛溪	萬盛溪
万目睽睽	萬目睽睽
万石	萬石
万福	萬福
万福玛丽亚	萬福瑪麗亞
万秀区	萬秀區
万种	萬種
万种风情	萬種風情
万窍	萬竅
万端	萬端
万签插架	萬籤插架
万箭攒心	萬箭攢心
万箭穿心	萬箭穿心
万箭穿身	萬箭穿身
万箱	萬箱
万籁	萬籟
万籁俱寂	萬籟俱寂
万籁无声	萬籟無聲
万籤插架	萬籤插架
万米	萬米
万米长跑	萬米長跑
万紫千红	萬紫千紅
万红千紫	萬紅千紫
万绪千头	萬緒千頭
万绪千端	萬緒千端
万维网	萬維網
万绿丛中	萬綠叢中
万缕千丝	萬縷千絲
万缘	萬緣
万能	萬能
万能工专	萬能工專
万能曲尺	萬能曲尺
万能梗	萬能梗
万能梗犬	萬能梗犬
万能胶	萬能膠
万能选手	萬能選手
万能钥匙	萬能鑰匙
万能锅	萬能鍋
万般	萬般
万般皆下品	萬般皆下品
万般皆是命	萬般皆是命
万艾可	萬艾可
万花争艳	萬花爭豔
万花筒	萬花筒
万苦千辛	萬苦千辛
万荣乡	萬榮鄉
万荣县	萬榮縣
万虑俱清	萬慮俱清
万言	萬言
万言书	萬言書
万语千言	萬語千言
万象	萬象
万象包罗	萬象包羅
万象更新	萬象更新
万象森罗	萬象森羅
万贯	萬貫
万贯家产	萬貫家產
万贯家私	萬貫家私
万贯家财	萬貫家財
万载千秋	萬載千秋
万载县	萬載縣
万道	萬道
万那杜	萬那杜
万邦	萬邦
万部	萬部
万里	萬里
万里之望	萬里之望
万里乡	萬里鄉
万里侯	萬里侯
万里同风	萬里同風
万里封侯	萬里封侯
万里无云	萬里無雲
万里春愁直	萬裏春愁直
万里晴空	萬里晴空
万里江山	萬里江山
万里迢迢	萬里迢迢
万里追踪	萬里追蹤
万里长城	萬里長城
万里长征	萬里長征
万里长江	萬里長江
万里长空	萬里長空
万里鹏程	萬里鵬程
万里鹏翼	萬里鵬翼
万重	萬重
万重山	萬重山
万金	萬金
万金不换	萬金不換
万金之躯	萬金之軀
万金油	萬金油
万钧	萬鈞
万钧之力	萬鈞之力
万锺	萬鍾
万难	萬難
万顷	萬頃
万顷琉璃	萬頃琉璃
万顷碧波	萬頃碧波
万馀	萬餘
万马	萬馬
万马千军	萬馬千軍
万马奔腾	萬馬奔騰
万马皆瘖	萬馬皆瘖
万马齐喑	萬馬齊喑
万马齐瘖	萬馬齊瘖
万鸦老	萬鴉老
万齐融	萬齊融
丈余	丈餘
丈八灯台	丈八燈臺
丈母娘	丈母孃
三万	三萬
三个	三個
三个鼻子管	三個鼻子管
三丰	三豐
三仙台	三仙臺
三代同堂	三代同堂
三余	三餘
三元合金	三元合金
三元里	三元里
三克	三克
三党	三黨
三八制	三八制
三冬	三冬
三冬两夏	三冬兩夏
三准	三準
三出祁山	三出祁山
三分钟	三分鐘
三只	三隻
三只手	三隻手
三台	三臺
三台县	三臺縣
三台联播	三臺聯播
三叶期	三葉期
三叶松	三葉松
三叶草	三葉草
三叶虫	三葉蟲
三叹	三嘆
三合会	三合會
三合土	三合土
三合房	三合房
三合星	三合星
三合板	三合板
三合院	三合院
三同	三同
三向	三向
三周	三週
三周年	三週年
三呼万岁	三呼萬歲
三回两转	三回兩轉
三回九曲	三回九曲
三回九转	三回九轉
三回五次	三回五次
三回五转	三回五轉
三国志	三國志
三坛大戒	三壇大戒
三复	三複
三复斯言	三復斯言
三复白圭	三復白圭
三大发明	三大發明
三大差别	三大差別
三天后	三天後
三头两面	三頭兩面
三头马车制	三頭馬車制
三夹板	三夾板
三娘教子	三孃教子
三对三斗牛	三對三鬥牛
三对六面	三對六面
三尸	三尸
三尸神	三尸神
三年制	三年制
三弦	三絃
三征七辟	三徵七辟
三思台	三思臺
三思而后	三思而後
三思而后行	三思而後行
三恶道	三惡道
三战两胜	三戰兩勝
三才	三才
三才图会	三才圖會
三扎	三紮
三折肱	三折肱
三折肱为良医	三折肱爲良醫
三振出局	三振出局
三方面	三方面
三日不读书面目可憎	三日不讀書面目可憎
三星集团	三星集團
三月里的桃花	三月裏的桃花
三杆	三杆
三杠	三槓
三杯	三杯
三杯和万事	三杯和萬事
三杯鸡	三杯雞
三板	三板
三极	三極
三极真空	三極真空
三极管	三極管
三次曲线	三次曲線
三段制	三段制
三江并流	三江並流
三浴三熏	三浴三熏
三涂	三塗
三点钟	三點鐘
三熏三沐	三熏三沐
三班制	三班制
三瓦两舍	三瓦兩舍
三瓦四舍	三瓦四舍
三生有幸	三生有幸
三用表	三用表
三番四复	三番四復
三百万	三百萬
三百个	三百個
三百千千	三百千千
三百多万	三百多萬
三百馀万	三百餘萬
三秋	三秋
三秒钟	三秒鐘
三穗	三穗
三穗县	三穗縣
三级三审制	三級三審制
三结合	三結合
三统历	三統曆
三统历史	三統歷史
三胜制	三勝制
三脚采茶戏	三腳採茶戲
三舍	三舍
三苏	三蘇
三表	三表
三角关系	三角關係
三角套汇	三角套匯
三角巾包扎法	三角巾包紮法
三角板	三角板
三角表	三角表
三辟	三辟
三连胜	三連勝
三部合唱	三部合唱
三部曲	三部曲
三里屯	三里屯
三里河	三里河
三针	三針
三长制	三長制
三门干部	三門幹部
三青团	三青團
三面	三面
三面亚当	三面亞當
三面体	三面體
三面夏娃	三面夏娃
三面红旗	三面紅旗
三面网	三面網
三面角	三面角
三马同槽	三馬同槽
三鹿集团	三鹿集團
上一个	上一個
上万	上萬
上上个月	上上個月
上下五千年	上下五千年
上下交困	上下交困
上下同心	上下同心
上下游	上下游
上不了	上不了
上不了台面	上不了檯面
上不得台盘	上不得檯盤
上个星期	上個星期
上个月	上個月
上中下游	上中下游
上了	上了
上了岁数	上了歲數
上了年纪	上了年紀
上党	上黨
上党梆子	上黨梆子
上冲	上衝
上冲下洗	上沖下洗
上千	上千
上千万	上千萬
上千人	上千人
上升	上升
上升为	上升爲
上升趋势	上升趨勢
上半叶	上半葉
上发条	上發條
上台	上臺
上台演唱	上臺演唱
上台演奏	上臺演奏
上台演讲	上臺演講
上叶	上葉
上合屋	上閤屋
上合组织	上合組織
上吊	上吊
上吊自杀	上吊自殺
上同调	上同調
上周	上週
上回	上回
上复	上覆
上夸克	上夸克
上层建筑	上層建築
上市柜	上市櫃
上弦	上弦
上当	上當
上彩	上彩
上搜	上搜
上杠	上槓
上柜	上櫃
上栗县	上栗縣
上梁	上樑
上梁不正	上樑不正
上梁不正下梁歪	上樑不正下樑歪
上梁山	上梁山
上梁文	上梁文
上游	上游
上游工业	上游工業
上百万	上百萬
上确界	上確界
上签	上籤
上签写	上簽寫
上签名	上簽名
上签字	上簽字
上签收	上簽收
上舍	上舍
上花台	上花臺
上药	上藥
上药膏	上藥膏
上蜡	上蠟
上表	上表
上课钟	上課鐘
上野树里	上野樹里
上链	上鍊
上面	上面
上马杯	上馬杯
下一个	下一個
下三面	下三面
下下个月	下下個月
下不了	下不了
下不了台	下不了臺
下不来台	下不來臺
下个星期	下個星期
下个月	下個月
下了	下了
下于	下於
下仑路	下崙路
下冲	下衝
下出	下出
下划线	下劃線
下厂	下廠
下发	下發
下台	下臺
下台阶	下臺階
下叶	下葉
下同	下同
下向	下向
下周	下週
下咽	下嚥
下回	下回
下城里	下城裏
下夸克	下夸克
下弦	下弦
下彩	下彩
下得了	下得了
下手干	下手幹
下才	下才
下摆	下襬
下有苏杭	下有蘇杭
下板儿	下板兒
下梁	下樑
下水道系统	下水道系統
下注	下注
下注解	下註解
下游	下游
下游工业	下游工業
下确界	下確界
下种	下種
下笔千言	下筆千言
下签	下籤
下签写	下簽寫
下签名	下簽名
下签字	下簽字
下签收	下簽收
下药	下藥
下表	下表
下课后	下課後
下课钟	下課鐘
下采	下采
下里	下里
下里巴人	下里巴人
下面	下面 下麪
下面请看	下面請看
下风方向	下風方向
下马杯	下馬杯
不一致	不一致
不一致字	不一致字
不上台盘	不上檯盤
不下于	不下於
不丑	不醜
不世出	不世出
不中于款	不中於款
不丰不杀	不豐不殺
不为牛后	不爲牛後
不为米折腰	不爲米折腰
不乐于	不樂於
不了	不了
不了之局	不了之局
不了了之	不了了之
不了了当	不了了當
不了情	不了情
不了汉	不了漢
不了解	不瞭解
不以词害志	不以詞害志
不以辞害志	不以辭害志
不体面	不體面
不作准	不作準
不侮暗室	不侮暗室
不修	不修
不修小节	不修小節
不修帷薄	不修帷薄
不修边幅	不修邊幅
不借	不借
不值当	不值當
不假外出	不假外出
不偏极	不偏極
不停当	不停當
不光彩	不光彩
不克	不克
不克制	不剋制
不克自制	不克自制
不全症	不全症
不再出版	不再出版
不准	不準 不准
不准他	不准他
不准你	不准你
不准备	不準備
不准她	不准她
不准它	不准它
不准我	不准我
不准没	不准沒
不准确	不準確
不准翻印	不准翻印
不准许	不准許
不准谁	不准誰
不准问	不准問
不减当年	不減當年
不出	不出
不出去	不出去
不出所料	不出所料
不出材	不出材
不出来	不出來
不分胜负	不分勝負
不分胜败	不分勝敗
不分青红皂白	不分青紅皁白
不切合实际	不切合實際
不划算	不划算
不利于	不利於
不前不后	不前不後
不加修饰	不加修飾
不加区别	不加區別
不加自制	不加自制
不劳无获	不勞無獲
不劳而获	不勞而獲
不升	不升
不升反降	不升反降
不单只是	不單只是
不卜可知	不卜可知
不占	不佔
不占凶吉	不占凶吉
不占卜	不占卜
不占吉凶	不占吉凶
不占算	不占算
不发心	不發心
不变价格	不變價格
不只	不只
不只是	不只是
不可以道里计	不可以道里計
不可同年而语	不可同年而語
不可同日	不可同日
不可同日而语	不可同日而語
不可向迩	不可向邇
不可当	不可當
不可战胜	不可戰勝
不可挽回	不可挽回
不可救药	不可救藥
不可胜书	不可勝書
不可胜原	不可勝原
不可胜数	不可勝數
不可胜纪	不可勝紀
不可胜言	不可勝言
不可胜计	不可勝計
不可胜记	不可勝記
不吃烟火食	不吃煙火食
不合	不合
不合体统	不合體統
不合作	不合作
不合作运动	不合作運動
不合式	不合式
不合时宜	不合時宜
不合标准	不合標準
不合格	不合格
不合法	不合法
不合理	不合理
不合算	不合算
不合群	不合羣
不合节	不合節
不合规定	不合規定
不合适	不合適
不合逻辑	不合邏輯
不吊	不弔
不同	不同
不同于	不同於
不同人	不同人
不同以往	不同以往
不同凡响	不同凡響
不同印本	不同印本
不同处	不同處
不同意	不同意
不同日月	不同日月
不同点	不同點
不同调	不同調
不向	不向
不告而别	不告而別
不周	不周
不周到	不周到
不周山	不周山
不周延	不周延
不周风	不周風
不善于	不善於
不图打点只图混水	不圖打點只圖混水
不在了	不在了
不堪回首	不堪回首
不复	不復
不复存在	不復存在
不外借	不外借
不多于	不多於
不多几日	不多幾日
不大合时	不大合時
不大精采	不大精采
不好了	不好了
不好干涉	不好干涉
不好干預	不好干預
不好干预	不好干預
不嫌母丑	不嫌母醜
不孕症	不孕症
不孝有三无后为大	不孝有三無後爲大
不学亡术	不學亡術
不学无术	不學無術
不安于位	不安於位
不安于室	不安於室
不完全叶	不完全葉
不寒而栗	不寒而慄
不对腔板	不對腔板
不小于	不小於
不少于	不少於
不尽	不盡
不尽年	不盡年
不尽心	不盡心
不尽木	不盡木
不尽根	不盡根
不尽然	不盡然
不尽相同	不盡相同
不尽道理	不盡道理
不屑于	不屑於
不属于	不屬於
不差毫厘	不差毫釐
不差毫发	不差毫髮
不干	不幹 不乾
不干不净	不乾不淨
不干不淨吃了没病	不乾不淨吃了沒病
不干了	不幹了
不干事	不幹事
不干他	不干他
不干休	不干休
不干你	不干你
不干净	不乾淨
不干她	不干她
不干它	不干它
不干己事	不干己事
不干性	不乾性
不干我	不干我
不干扰	不干擾
不干杯	不乾杯
不干涉	不干涉
不干涉主义	不干涉主義
不干渴	不乾渴
不干犯	不干犯
不干着急	不乾着急
不干胶	不乾膠
不干脆	不乾脆
不干裂	不乾裂
不干预	不干預
不并	不併
不幸	不幸
不幸之事	不幸之事
不幸之幸	不幸之幸
不幸受害	不幸受害
不幸的是	不幸的是
不当	不當
不当一回事	不當一回事
不当不对	不當不對
不当不正	不當不正
不当事	不當事
不当人	不當人
不当人化化	不當人化化
不当人子	不當人子
不当党	不當黨
不当党产	不當黨產
不当准	不當準
不当官	不當官
不当家	不當家
不当家化化	不當家化化
不当家花拉	不當家花拉
不当家花花	不當家花花
不当家豁拉	不當家豁拉
不当得利	不當得利
不当数	不當數
不当稳便	不當穩便
不当紧	不當緊
不当耍处	不當耍處
不当道	不當道
不形于色	不形於色
不彩	不彩
不徇颜面	不徇顏面
不得了	不得了
不得台盘	不得檯盤
不得志	不得志
不得闲	不得閒
不念	不念
不念旧恶	不念舊惡
不恶而严	不惡而嚴
不情不愿	不情不願
不情愿	不情願
不惮强御	不憚強禦
不愿	不願
不愿意	不願意
不成才	不成才
不战而胜	不戰而勝
不才	不才
不打不成才	不打不成才
不托	不託
不扣	不扣
不折	不折
不折不扣	不折不扣
不挂	不掛
不挂眼	不掛眼
不放松	不放鬆
不敢出声	不敢出聲
不敢出气	不敢出氣
不敢后人	不敢後人
不敢当	不敢當
不整合	不整合
不斗	不鬥
不断电系统	不斷電系統
不早了	不早了
不时之须	不時之須
不明就里	不明就裏
不明确	不明確
不是个儿	不是個兒
不是了处	不是了處
不是别人	不是別人
不松下	不鬆下
不极	不極
不极不反	不極不反
不染纤尘	不染纖塵
不标准	不標準
不欲	不欲
不欺暗室	不欺暗室
不止于此	不止於此
不正当	不正當
不正当关系	不正當關係
不正当竞争	不正當競爭
不正确	不正確
不死药	不死藥
不毒不发	不毒不發
不气干	不氣干
不求收获	不求收獲
不治之症	不治之症
不注意	不注意
不测风云	不測風雲
不涂	不塗
不消几日	不消幾日
不甘于	不甘於
不甘后人	不甘後人
不甚了了	不甚了了
不甚合意	不甚合意
不用干	不用幹
不用斗了	不用鬥了
不畏强御	不畏強禦
不畏彊御	不畏彊禦
不留情面	不留情面
不相同	不相同
不相干	不相干
不知凡几	不知凡幾
不知去向	不知去向
不知所云	不知所云
不确	不確
不确定	不確定
不确定性	不確定性
不确定性原理	不確定性原理
不确定感	不確定感
不确定故意	不確定故意
不确实	不確實
不符合	不符合
不等于	不等於
不等价交换	不等價交換
不管闲事	不管閒事
不系	不繫
不系舟	不繫舟
不约而合	不約而合
不约而同	不約而同
不织布	不織布
不结汇进口	不結匯進口
不绝于耳	不絕於耳
不老药	不老藥
不肯干休	不肯干休
不育症	不育症
不胜	不勝
不胜之态	不勝之態
不胜其扰	不勝其擾
不胜其烦	不勝其煩
不胜其苦	不勝其苦
不胜唏嘘	不勝唏噓
不胜感喟	不勝感喟
不胜感激	不勝感激
不胜春	不勝春
不胜枚举	不勝枚舉
不胜衣	不勝衣
不胜负荷	不勝負荷
不胜酒力	不勝酒力
不能出口	不能出口
不能尽数	不能盡數
不能胜数	不能勝數
不能自制	不能自制
不能赞一辞	不能贊一辭
不至于	不至於
不致	不致
不致于	不致於
不舍	不捨
不舍得	不捨得
不舍昼夜	不捨晝夜
不舒适	不舒適
不良于行	不良於行
不良倾向	不良傾向
不良才	不良才
不良适应	不良適應
不药而愈	不藥而癒
不药而癒	不藥而癒
不获	不獲
不落人后	不落人後
不虚发	不虛發
不行了	不行了
不表	不表
不见世面	不見世面
不见了	不見了
不见识面	不見識面
不见面	不見面
不规范	不規範
不解之仇	不解之仇
不讨采	不討采
不让须眉	不讓鬚眉
不讲情面	不講情面
不识局面	不識局面
不识闲	不識閒
不说价	不說價
不说出	不說出
不谈别的	不談別的
不谋而合	不謀而合
不谋而同	不謀而同
不谐当	不諧當
不谷	不穀
不负所托	不負所托
不赞	不讚
不赞一词	不讚一詞
不赞一辞	不讚一辭
不赞同	不贊同
不赞成	不贊成
不足为据	不足爲據
不足之症	不足之症
不足回旋	不足回旋
不足挂齿	不足掛齒
不足采信	不足採信
不辞而别	不辭而別
不远万里	不遠萬里
不远千里	不遠千里
不连续面	不連續面
不适	不適
不适合	不適合
不适当	不適當
不适感	不適感
不适用	不適用
不逊于	不遜於
不透明水彩画	不透明水彩畫
不通吊庆	不通弔慶
不遗余力	不遺餘力
不避彊御	不避彊禦
不采	不採
不采声	不采聲
不锈钢	不鏽鋼
不锈钢板	不鏽鋼板
不问前因后果	不問前因後果
不问是非曲直	不問是非曲直
不降反升	不降反升
不限于	不限於
不须	不須
不顾前后	不顧前後
不顾后果	不顧後果
不顾曲直	不顧曲直
不顾闲野	不顧閒野
不食人间烟火	不食人間煙火
不食周粟	不食周粟
不食干腊	不食乾腊
不食烟火	不食煙火
不龟手药	不龜手藥
不龟药	不龜藥
与他一斗	與他一鬥
与众不同	與衆不同
与克制	與剋制
与党	與黨
与君一席话胜读十年书	與君一席話勝讀十年書
与国同休	與國同休
与她一斗	與她一鬥
与子同袍	與子同袍
与日同辉	與日同輝
与此同时	與此同時
与民同乐	與民同樂
与民同忧	與民同憂
丑三	丑三
丑丑	醜醜
丑丫头	醜丫頭
丑事	醜事
丑于	醜於
丑人	醜人
丑人多作怪	醜人多作怪
丑侪	醜儕
丑八怪	醜八怪
丑剌剌	醜剌剌
丑剧	醜劇
丑化	醜化
丑史	醜史
丑名	醜名
丑咤	醜吒
丑地	醜地
丑声	醜聲
丑声四溢	醜聲四溢
丑声远播	醜聲遠播
丑头怪脸	醜頭怪臉
丑夷	醜夷
丑女	醜女
丑女人	醜女人
丑女效颦	醜女效顰
丑奴儿	醜奴兒
丑妇	醜婦
丑媳	醜媳
丑媳妇	醜媳婦
丑媳妇总得要见公婆	醜媳婦總得要見公婆
丑小鸭	醜小鴨
丑巴怪	醜巴怪
丑年	丑年
丑徒	醜徒
丑态	醜態
丑态毕露	醜態畢露
丑态百出	醜態百出
丑怪	醜怪
丑恶	醜惡
丑日	丑日
丑旦	丑旦
丑时	丑時
丑月	丑月
丑末	醜末
丑杂	醜雜
丑样	醜樣
丑死	醜死
丑比	醜比
丑毙了	醜斃了
丑沮	醜沮
丑牛	丑牛
丑生	醜生
丑男	醜男
丑相	醜相
丑类	醜類
丑类恶物	醜類惡物
丑脸	醜臉
丑虏	醜虜
丑行	醜行
丑角	丑角
丑言	醜言
丑诋	醜詆
丑话	醜話
丑语	醜語
丑贼生	醜賊生
丑辞	醜辭
丑辱	醜辱
丑逆	醜逆
丑闻	醜聞
丑闻案	醜聞案
丑陋	醜陋
专业人才	專業人才
专修	專修
专修班	專修班
专修科	專修科
专修科目	專修科目
专利药	專利藥
专利药品	專利藥品
专制	專制
专制主义	專制主義
专制制度	專制制度
专制君主制	專制君主制
专制政体	專制政體
专制政府	專制政府
专制政治	專制政治
专制权	專制權
专制起来	專制起來
专勤制度	專勤制度
专向	專向
专家系统	專家系統
专家评价	專家評價
专干	專幹
专征	專征
专心一志	專心一志
专心致志	專心致志
专才	專才
专摆	專擺
专柜	專櫃
专柜小姐	專櫃小姐
专欲难成	專欲難成
专注	專注
专注力	專注力
专精于	專精於
专美于前	專美於前
专辑里	專輯裏
专鉴	專鑒
专门人才	專門人才
专门术语	專門術語
且于	且於
且听下回分解	且聽下回分解
世上无难事只怕有心人	世上無難事只怕有心人
世仇	世仇
世出世	世出世
世台	世臺
世台会	世臺會
世彩堂	世綵堂
世彩堂帖	世綵堂帖
世恩录	世恩錄
世情看冷暖人面逐高低	世情看冷暖人面逐高低
世所周知	世所周知
世田谷	世田谷
世界大同	世界大同
世界旅游组织	世界旅遊組織
世界杯	世界盃
世界杯室	世界盃室
世界杯赛	世界盃賽
世界纪录	世界紀錄
世界范围	世界範圍
世界里	世界裏
世系	世系
世纪钟	世紀鐘
世纪钟表	世紀鐘錶
世胄	世胄
世表	世表
世阿弥	世阿彌
世面	世面
丘克	丘克
丙种	丙種
丙种射线	丙種射線
丙舍	丙舍
业余	業餘
业余大学	業餘大學
业余教育	業餘教育
业余爱好	業餘愛好
业余者	業餘者
业务范围	業務範圍
业界标准	業界標準
业种	業種
业精于勤	業精於勤
业荒于嬉	業荒於嬉
业馀电台	業餘電臺
丛台区	叢臺區
丛生叶	叢生葉
东丰	東豐
东丰县	東豐縣
东丰阁	東豐閣
东京柜	東京櫃
东仓里	東倉里
东伙	東夥
东冲西突	東衝西突
东加里曼丹	東加里曼丹
东北向	東北向
东北面	東北面
东升	東昇
东南向	東南向
东南面	東南面
东厂	東廠
东台	東臺
东台市	東臺市
东台湾	東臺灣
东向	東向
东周	東周
东周时	東周時
东周时代	東周時代
东周时期	東周時期
东周钟	東周鐘
东奔西向	東奔西向
东学党	東學黨
东山之志	東山之志
东山里	東山里
东山里站	東山里站
东岳	東嶽
东干	東干
东征	東征
东征西怨	東征西怨
东征西讨	東征西討
东扬西荡	東揚西蕩
东折西绕	東折西繞
东挨西撞	東挨西撞
东挪西借	東挪西借
东摇西摆	東搖西擺
东方发白	東方發白
东方汇理	東方匯理
东林党	東林黨
东欧集团	東歐集團
东海捞针	東海撈針
东涂西抹	東塗西抹
东淨里的砖儿	東淨裏的磚兒
东游	東遊
东窗事发	東窗事發
东胜区	東勝區
东胡	東胡
东芝医疗系	東芝醫療繫
东荡西除	東蕩西除
东蒙	東蒙
东西向	東西向
东西周	東西周
东讨西征	東討西征
东谷拉瓦	東谷拉瓦
东邻西舍	東鄰西舍
东里	東里
东量西折	東量西折
东面	東面
东飘西荡	東飄西蕩
丝发	絲髮
丝发之功	絲髮之功
丝布	絲布
丝弦	絲絃
丝恩发怨	絲恩髮怨
丝托索	絲托索
丝挂子	絲掛子
丝杆	絲桿
丝杠	絲槓
丝来线去	絲來線去
丝板	絲板
丝瓜布	絲瓜布
丝盘虫	絲盤蟲
丝线	絲線
丝织厂	絲織廠
丝绒布	絲絨布
丝虫	絲蟲
丝虫病	絲蟲病
丢丑	丟醜
丢了	丟了
丢体面	丟體面
丢入爪哇国里	丟入爪哇國裏
丢出	丟出
丢出去	丟出去
丢包术	丟包術
丢在脑后	丟在腦後
丢巧针	丟巧針
丢面子	丟面子
两万	兩萬
两个	兩個
两个中国	兩個中國
两个或两个以上	兩個或兩個以上
两个或更多	兩個或更多
两个肩膀扛张嘴	兩個肩膀扛張嘴
两人同心	兩人同心
两余	兩餘
两克	兩克
两党	兩黨
两千	兩千
两厢情愿	兩廂情願
两只	兩隻
两只手	兩隻手
两只脚赶不上一张嘴	兩隻腳趕不上一張嘴
两台	兩臺
两叶	兩葉
两叶掩目	兩葉掩目
两合公司	兩合公司
两周	兩週
两周年	兩週年
两回	兩回
两回事	兩回事
两国关系	兩國關係
两天后	兩天後
两天晒网	兩天曬網
两头三面	兩頭三面
两头白面	兩頭白面
两娘女	兩娘女
两岸关系	兩岸關係
两当	兩當
两当一	兩當一
两当县	兩當縣
两性关系	兩性關係
两情两愿	兩情兩願
两扎	兩紮
两撇胡	兩撇鬍
两方面	兩方面
两杆	兩杆
两杠	兩槓
两杯	兩杯
两板	兩板
两极	兩極
两极分化	兩極分化
两极化	兩極化
两极管	兩極管
两极观点	兩極觀點
两段制	兩段制
两点钟	兩點鐘
两班制	兩班制
两百万	兩百萬
两百个	兩百個
两百多万	兩百多萬
两相情愿	兩相情願
两眼发直	兩眼發直
两种	兩種
两种人	兩種人
两秒钟	兩秒鐘
两腿发软	兩腿發軟
两虎共斗	兩虎共鬥
两虎相斗	兩虎相鬥
两西西里王国	兩西西里王國
两院制	兩院制
两面	兩面
两面三刀	兩面三刀
两面不是人	兩面不是人
两面不讨好	兩面不討好
两面二舌	兩面二舌
两面作战	兩面作戰
两面倒	兩面倒
两面光	兩面光
两面刀	兩面刀
两面夹攻	兩面夾攻
两面性	兩面性
两面手法	兩面手法
两面派	兩面派
两面讨好	兩面討好
两面转圜	兩面轉圜
两面锯	兩面鋸
两面顾全	兩面顧全
两鼠斗穴	兩鼠鬥穴
严丝合缝	嚴絲合縫
严了眼儿	嚴了眼兒
严于	嚴於
严于律己	嚴於律己
严云农	嚴云農
严冬	嚴冬
严制	嚴制
严加防范	嚴加防範
严复	嚴復
严恶	嚴惡
严禁吸烟	嚴禁吸菸
严禁烟火	嚴禁煙火
严重后果	嚴重後果
丧失殆尽	喪失殆盡
丧尸	喪屍
丧尽	喪盡
丧尽天良	喪盡天良
丧志	喪志
丧荡游魂	喪蕩游魂
丧钟	喪鐘
个个	個個
个个称羡	個個稱羨
个中	箇中
个中三昧	箇中三昧
个中人	箇中人
个中原因	箇中原因
个中奥妙	箇中奧妙
个中奥秘	箇中奧祕
个中好手	箇中好手
个中强手	箇中強手
个中消息	箇中消息
个中滋味	箇中滋味
个中玄机	箇中玄機
个中理由	箇中理由
个中讯息	箇中訊息
个中资讯	箇中資訊
个中道理	箇中道理
个中高手	箇中高手
个事	個事
个人	個人
个人主义	個人主義
个人伤害	個人傷害
个人储蓄	個人儲蓄
个人利益	個人利益
个人化	個人化
个人单季	個人單季
个人卫生	個人衛生
个人外交	個人外交
个人奖	個人獎
个人崇拜	個人崇拜
个人工作室	個人工作室
个人得失	個人得失
个人性	個人性
个人所得	個人所得
个人所得税	個人所得稅
个人护理	個人護理
个人拨接	個人撥接
个人本位	個人本位
个人消费	個人消費
个人用	個人用
个人用户	個人用戶
个人电脑	個人電腦
个人组	個人組
个人网站	個人網站
个人资料	個人資料
个人赛	個人賽
个人隐私	個人隱私
个人风	個人風
个人首页	個人首頁
个位	個位
个位数	個位數
个体	個體
个体发育	個體發育
个体户	個體戶
个体所有	個體所有
个体经济	個體經濟
个例	個例
个儿	個兒
个别	個別
个别差异	個別差異
个别性	個別性
个别情况	個別情況
个别指导	個別指導
个别教学	個別教學
个别测验	個別測驗
个别现象	個別現象
个别生产	個別生產
个别谈话	個別談話
个别辅导	個別輔導
个头	個頭
个头儿	個頭兒
个子	個子
个屁阿	個屁阿
个展	個展
个性	個性
个性化	個性化
个性难改	個性難改
个把	個把
个把月	個把月
个数	個數
个旧	箇舊
个旧县	箇舊縣
个旧市	箇舊市
个样	個樣
个核	個核
个案	個案
个案分析	個案分析
个案研究	個案研究
个案纪录	個案紀錄
个股为	個股爲
个过客	個過客
个钟	個鐘
个钟表	個鐘錶
中上游	中上游
中下游	中下游
中书舍人	中書舍人
中了暑	中了暑
中了标	中了標
中了毒	中了毒
中于	中於
中云	中雲
中介社团	中介社團
中仑	中崙
中仑站	中崙站
中价位	中價位
中低价位	中低價位
中俄关系	中俄關系
中千世界	中千世界
中华台北	中華臺北
中华电视台	中華電視臺
中华肝吸虫病	中華肝吸蟲病
中华苏维埃共和国	中華蘇維埃共和國
中华革命党	中華革命黨
中原板荡	中原板蕩
中原标准时间	中原標準時間
中台	中臺 中颱
中台医专	中臺醫專
中台湾	中臺灣
中台禅寺	中臺禪寺
中台科技大学	中臺科技大學
中叶	中葉
中国共产党	中國共產黨
中国制	中國製
中国制造	中國製造
中国剩余定理	中國剩餘定理
中国医药	中國醫藥
中国历史	中國歷史
中国同盟会	中國同盟會
中国国民党	中國國民黨
中型钟	中型鐘
中型钟表	中型鐘錶
中型钟表面	中型鐘表面
中型钟面	中型鐘面
中央专制集权	中央專制集權
中央党	中央黨
中央党部	中央黨部
中央台	中央臺
中央广播电台	中央廣播電臺
中央标准局	中央標準局
中央汇金	中央匯金
中央电视台	中央電視臺
中央监控系统	中央監控系統
中央空调系统	中央空調系統
中央面	中央面
中子俘获	中子俘獲
中岳	中嶽
中度台风	中度颱風
中彩	中彩
中心汇率	中心匯率
中恶	中惡
中懑之症	中懣之症
中才	中才
中控台	中控臺
中控面板	中控面板
中搜	中搜
中文台	中文臺
中文系	中文系
中文里	中文裏
中日关系	中日關係
中暗箭	中暗箭
中板	中板
中极	中極
中枢系统	中樞系統
中核	中核
中止症	中止症
中比关系	中比關係
中注模样	中注模樣
中涂	中塗
中港台	中港臺
中游	中游
中环杯	中環盃
中盘胜	中盤勝
中秋	中秋
中秋佳节	中秋佳節
中秋帖	中秋帖
中秋月饼	中秋月餅
中秋节	中秋節
中程计划	中程計劃
中筋面粉	中筋麪粉
中签	中籤
中美发表	中美發表
中胡	中胡
中草药	中草藥
中药	中藥
中药偏方	中藥偏方
中药学	中藥學
中药店	中藥店
中药房	中藥房
中药材	中藥材
中药铺	中藥鋪
中表	中表
中西合并	中西合併
中西合璧	中西合璧
中谷	中谷
中谷有蓷	中谷有蓷
中转柜台	中轉櫃檯
中远集团	中遠集團
中远香港集团	中遠香港集團
中间纤维	中間纖維
中风后	中風後
丰上锐下	豐上銳下
丰下	豐下
丰丘明	豐丘明
丰业	豐業
丰乐	豐樂
丰乐亭	豐樂亭
丰产	豐產
丰产田	豐產田
丰亨豫大	豐亨豫大
丰仪	丰儀
丰伟	豐偉
丰俭由人	豐儉由人
丰儀	丰儀
丰功	豐功
丰功伟业	豐功偉業
丰功伟绩	豐功偉績
丰功厚利	豐功厚利
丰功大业	豐功大業
丰功懋烈	豐功懋烈
丰功盛烈	豐功盛烈
丰华	豐華
丰南	豐南
丰南区	豐南區
丰厚	豐厚
丰原	豐原
丰原市	豐原市
丰县	豐縣
丰取刻与	豐取刻與
丰台	豐臺
丰台区	豐臺區
丰城	豐城
丰城剑气	豐城劍氣
丰城市	豐城市
丰城贯斗	豐城貫斗
丰壤	豐壤
丰奢	豐奢
丰妍	豐妍
丰姿	丰姿
丰姿冶丽	丰姿冶麗
丰姿绰约	丰姿綽約
丰宁	豐寧
丰宁县	豐寧縣
丰实	豐實
丰容	丰容
丰容靓饰	豐容靚飾
丰富	豐富
丰富多彩	豐富多彩
丰富性	豐富性
丰川悦司	豐川悅司
丰年	豐年
丰年玉	豐年玉
丰年祭	豐年祭
丰年稔岁	豐年稔歲
丰年节	豐年節
丰年虾	豐年蝦
丰度	丰度 豐度
丰悴	豐悴
丰情	丰情
丰收	豐收
丰收年	豐收年
丰本	豐本
丰杀	豐殺
丰标	丰標
丰标不凡	丰標不凡
丰歉	豐歉
丰殖	豐殖
丰水	豐水
丰水期	豐水期
丰沛	豐沛
丰注	豐注
丰泽	豐澤
丰泽区	豐澤區
丰润	豐潤
丰润区	豐潤區
丰渔桥	豐漁橋
丰溪里	豐溪里
丰满	豐滿
丰满区	豐滿區
丰滨	豐濱
丰滨乡	豐濱鄉
丰炽	豐熾
丰熟	豐熟
丰田	豐田
丰登	豐登
丰盈	豐盈
丰盛	豐盛
丰硕	豐碩
丰碑	豐碑
丰神	丰神
丰神俊美	丰神俊美
丰神异彩	豐神異彩
丰神绰约	丰神綽約
丰神飘洒	丰神飄灑
丰稔	豐稔
丰穰	豐穰
丰美	豐美
丰耗	豐耗
丰肌	豐肌
丰胸	豐胸
丰腆	豐腆
丰腴	豐腴
丰臣秀吉	豐臣秀吉
丰若晖	豐若暉
丰若有肌柔若无骨	丰若有肌柔若無骨
丰茂	豐茂
丰茸	丰茸
丰草	豐草
丰蔚	豐蔚
丰衍	豐衍
丰衣足食	豐衣足食
丰裕	豐裕
丰赡	豐贍
丰足	豐足
丰都	豐都
丰都县	豐都縣
丰采	丰采
丰镇	豐鎮
丰镇市	豐鎮市
丰镐	豐鎬
丰隆	豐隆
丰韵	丰韻
丰韻	丰韻
丰顺	豐順
丰顺县	豐順縣
丰颊	豐頰
丰饶	豐饒
丰饶丰足	豐饒豐足
串亲戚	串親戚
串出来	串出來
串同	串同
串哄	串哄
串游	串游
临别	臨別
临别依依	臨別依依
临别时	臨別時
临别赠言	臨別贈言
临制	臨制
临危致命	臨危致命
临去秋波	臨去秋波
临夏回族自治州	臨夏回族自治州
临幸	臨幸
临床特征	臨牀特徵
临机制变	臨機制變
临机制胜	臨機制勝
临江折轴	臨江折軸
临海水土志	臨海水土誌
临潼斗宝	臨潼鬥寶
丸药	丸藥
丸药盒	丸藥盒
丹参	丹蔘
丹台	丹臺
丹布朗	丹布朗
丹干	丹干
丹徒布衣	丹徒布衣
丹朱	丹朱
丹药	丹藥
为中台	爲中颱
为了	爲了
为人师表	爲人師表
为准	爲準
为念	爲念
为恶不悛	爲惡不悛
为所欲为	爲所欲爲
为模范	爲模範
为着	爲着
为规范	爲規範
为鉴	爲鑑
主仆	主僕
主修	主修
主修科目	主修科目
主席台	主席臺
主席团	主席團
主干	主幹
主干家庭	主幹家庭
主干线	主幹線
主干网络	主幹網絡
主干网路	主幹網路
主控台	主控臺
主播台	主播臺
主教团	主教團
主普坛	主普壇
主机板	主機板
主板	主板
主梁	主樑
主法向量	主法向量
主画面	主畫面
主要树种	主要樹種
主钟差	主鐘差
主钟曲线	主鐘曲線
主题曲	主題曲
主题论坛区	主題論壇區
丽于	麗於
丽舍	麗舍
举不胜举	舉不勝舉
举了	舉了
举例发凡	舉例發凡
举出	舉出
举出来	舉出來
举发	舉發
举尾虫	舉尾蟲
举手可采	舉手可采
举手表	舉手表
举手表决	舉手表決
举措失当	舉措失當
举杯	舉杯 舉盃
举杯畅饮	舉杯暢飲
举止闲冶	舉止閒冶
举目千里	舉目千里
举荐征辟	舉薦征辟
乃至于	乃至於
乃里	乃里
久仰山斗	久仰山斗
久别	久別
久别相逢	久別相逢
久别重逢	久別重逢
久违颜范	久違顏範
么娘	麼娘
义义合合	義義合合
义仆	義僕
义占	義佔
义同生死	義同生死
义和团	義和團
义大利杯	義大利杯
义大利面	義大利麪
义庄	義莊
义形于色	義形於色
义气干霄	義氣干霄
义薄云天	義薄雲天
之于	之於
之余	之餘
之八九只	之八九只
之叹	之嘆
之后	之後
之征	之徵
之念	之念
之托	之託
之杯	之杯
之核	之核
之欲	之慾
之游	之遊
之秋	之秋
之鉴	之鑑
之钟	之鐘
乌东察克	烏東察克
乌东査克	烏東查克
乌云	烏雲
乌云密布	烏雲密佈
乌云蔽日	烏雲蔽日
乌什塔拉回族乡	烏什塔拉回族鄉
乌克丽丽	烏克麗麗
乌克兰	烏克蘭
乌克兰人	烏克蘭人
乌克兰籍	烏克蘭籍
乌克兰队	烏克蘭隊
乌兰察布	烏蘭察布
乌兰察布市	烏蘭察布市
乌兰巴托	烏蘭巴托
乌兹冲锋枪	烏茲衝鋒槍
乌兹别克	烏茲別克
乌兹别克人	烏茲別克人
乌兹别克共和国	烏茲別克共和國
乌兹别克斯坦	烏茲別克斯坦
乌兹别克族	烏茲別克族
乌冬面	烏冬面
乌发	烏髮
乌合	烏合
乌合之众	烏合之衆
乌合之卒	烏合之卒
乌孜别克	烏孜別克
乌孜别克族	烏孜別克族
乌孜别克语	烏孜別克語
乌干达	烏干達
乌干达共和国	烏干達共和國
乌当	烏當
乌当区	烏當區
乌托邦	烏托邦
乌拉特后旗	烏拉特後旗
乌松	烏松
乌梁海	烏梁海
乌梁海盆地	烏梁海盆地
乌沈沈	烏沈沈
乌洛托品	烏洛托品
乌涂	烏塗
乌涂水	烏塗水
乌滋别克	烏滋別克
乌滋别克斯坦	烏滋別克斯坦
乌烟瘴气	烏煙瘴氣
乌狗吃食白狗当灾	烏狗吃食白狗當災
乌苏	烏蘇
乌苏市	烏蘇市
乌苏拉	烏蘇拉
乌苏里斯克	烏蘇里斯克
乌苏里江	烏蘇里江
乌药	烏藥
乌获	烏獲
乌菲兹美术馆	烏菲茲美術館
乌里	烏里
乌里雅苏台	烏里雅蘇臺
乌鲁克恰提	烏魯克恰提
乌鲁克恰提县	烏魯克恰提縣
乌鲁克穆河	烏魯克穆河
乌龙面	烏龍麪
乏困	乏困
乐不可极	樂不可極
乐于	樂於
乐于助人	樂於助人
乐合彩	樂合彩
乐器钟	樂器鐘
乐团	樂團
乐坏了	樂壞了
乐坛	樂壇
乐府杂录	樂府雜錄
乐意于	樂意於
乐曲	樂曲
乐极则悲	樂極則悲
乐极忘形	樂極忘形
乐极悲来	樂極悲來
乐极悲生	樂極悲生
乐极生悲	樂極生悲
乐游原	樂遊原
乐祸幸灾	樂禍幸災
乐透彩	樂透彩
乐颠了馅	樂顛了餡
乒乓球台	乒乓球檯
乔修亚	喬修亞
乔修亚．吉尔菲艾斯	喬修亞．吉爾菲艾斯
乔做胡为	喬做胡爲
乔岳	喬嶽
乔布斯	喬布斯
乔德里	喬德里
乔志	喬志
乔才	喬才
乔杰立	喬傑立
乔松	喬松
乔松之寿	喬松之壽
乔治克隆尼	喬治克隆尼
乔治克鲁尼	喬治克魯尼
乔治．布希	喬治．布希
乖别	乖別
乘了	乘了
乘云	乘雲
乘凶完配	乘凶完配
乘奔御风	乘奔御風
乘法表	乘法表
乘胜	乘勝
乘胜追击	乘勝追擊
乘胜逐北	乘勝逐北
乘鹤驾云	乘鶴駕雲
乙丑	乙丑
乙种	乙種
乙种射线	乙種射線
乙种粒子	乙種粒子
乙种维生素	乙種維生素
九世之仇	九世之仇
九个	九個
九个人	九個人
九个月	九個月
九九乘法表	九九乘法表
九九表	九九表
九亿五千万	九億五千萬
九余	九餘
九冬	九冬
九出祁山	九出祁山
九分钟	九分鐘
九划	九劃
九千点	九千點
九只	九隻
九台	九臺
九台市	九臺市
九合	九合
九合一匡	九合一匡
九吊六的	九吊六的
九回肠	九迴腸
九天后	九天後
九宵云	九宵雲
九宵云外	九宵雲外
九扎	九紮
九折	九折
九折优待	九折優待
九折臂	九折臂
九曲	九曲
九曲桥	九曲橋
九曲洞	九曲洞
九杯	九杯
九点钟	九點鐘
九炼成钢	九鍊成鋼
九百万	九百萬
九百个	九百個
九秋	九秋
九秒钟	九秒鐘
九章算术	九章算術
九谷	九穀
九里	九里
九里余	九里餘
九里区	九里區
九针	九針
九零后	九零後
九霄云外	九霄雲外
九面体	九面體
九香虫	九香蟲
九龙杯	九龍杯
九龙表行	九龍表行
乞力马扎罗山	乞力馬扎羅山
乞留恶滥	乞留惡濫
乞留曲律	乞留曲律
也不尽然	也不盡然
也克制	也剋制
也向	也向
也对于	也對於
也念	也念
也斗了胆	也斗了膽
也舍下	也舍下
也须	也須
习于	習於
习惯于	習慣於
习非胜是	習非勝是
乡党	鄉黨
乡党尚齿	鄉黨尚齒
乡团	鄉團
乡土艺术	鄉土藝術
乡愿	鄉愿
乡曲	鄉曲
乡曲之誉	鄉曲之譽
乡民代表	鄉民代表
乡民代表会	鄉民代表會
乡里	鄉里
乡里小人	鄉里小人
乡镇代表	鄉鎮代表
乡镇民代表	鄉鎮民代表
乡间别墅	鄉間別墅
乡面	鄉面
书不尽	書不盡
书不尽言	書不盡言
书中自有千钟粟	書中自有千鍾粟
书写不能症	書寫不能症
书刊杂志	書刊雜誌
书卷	書卷
书卷奖	書卷獎
书卷气	書卷氣
书台	書檯
书后	書後
书呆子	書呆子
书坛	書壇
书录	書錄
书报杂志	書報雜誌
书柜	書櫃
书种	書種
书签	書籤
书系	書系
书虫	書蟲
书虫子	書蟲子
书面	書面
书面上	書面上
书面报告	書面報告
书面纸	書面紙
书面许可	書面許可
书面语	書面語
书面资料	書面資料
乩坛	乩壇
买一个饶一个	買一個饒一個
买了	買了
买价	買價
买凶	買兇
买咸鱼放生	買鹹魚放生
买回	買回
买回去	買回去
买回家	買回家
买回来	買回來
买大彩	買大彩
买汇	買匯
买烟	買菸
买物历	買物歷
买臣复水	買臣覆水
买进对冲	買進對沖
买闲钱	買閒錢
买面子	買面子
买风云雷雨	買風雲雷雨
乱世凶年	亂世凶年
乱了	亂了
乱了手脚	亂了手腳
乱作一团	亂作一團
乱党	亂黨
乱冲	亂衝
乱发	亂髮
乱哄	亂鬨
乱哄不过来	亂鬨不過來
乱哄哄	亂哄哄
乱成一团	亂成一團
乱扣	亂扣
乱搞男女关系	亂搞男女關係
乱松松	亂鬆鬆
乱极则平	亂極則平
乱棒胡敲	亂棒胡敲
乱涂	亂塗
乱针绣	亂針繡
乱集团	亂集團
乱首垢面	亂首垢面
乳制品	乳製品
乳娘	乳孃
乳液聚合	乳液聚合
乳糖不耐症	乳糖不耐症
乳臭未干	乳臭未乾
乳药求死	乳藥求死
乾元	乾元
乾兌	乾兌
乾卦	乾卦
乾坤一掷	乾坤一擲
乾坤再造	乾坤再造
乾坤大挪移	乾坤大挪移
乾尽午中	乾盡午中
乾象历	乾象曆
乾隆	乾隆
乾隆年间	乾隆年間
乾隆皇帝	乾隆皇帝
了不得	了不得
了不成	了不成
了不起	了不起
了了	了了
了事	了事
了事环	了事環
了债	了債
了儿	了兒
了决	了決
了劣	了劣
了却	了卻
了却此生	了卻此生
了去	了去
了如	瞭如
了如指掌	瞭如指掌
了局	了局
了帐	了帳
了当	了當
了当不得	了當不得
了得	了得
了得了	了得了
了悟	了悟
了愿	了願
了手	了手
了收	了收
了断	了斷
了无	了無
了无挂碍	了無掛礙
了无新意	了無新意
了无牵挂	了無牽掛
了无生机	了無生機
了无生趣	了無生趣
了无痕迹	了無痕跡
了无罣碍	了無罣礙
了无长进	了無長進
了望	瞭望
了望台	瞭望臺
了望塔	瞭望塔
了望山	瞭望山
了望所	瞭望所
了案	了案
了此残生	了此殘生
了毕	了畢
了清	了清
了然	瞭然
了然不惑	瞭然不惑
了然于心	瞭然於心
了纳	了納
了结	了結
了若指掌	瞭若指掌
了落	了落
了解	瞭解
了解到	瞭解到
了讫	了訖
了话	了話
了语	了語
了账	了賬
了身达命	了身達命
了鸟	了鳥
争了	爭了
争先发言	爭先發言
争先后	爭先後
争先恐后	爭先恐後
争出	爭出
争奇斗妍	爭奇鬥妍
争奇斗异	爭奇鬥異
争奇斗艳	爭奇鬥豔
争妍斗奇	爭妍鬥奇
争妍斗胜	爭妍鬥勝
争妍斗艳	爭妍鬥豔
争强好胜	爭強好勝
争强斗胜	爭強鬥勝
争强显胜	爭強顯勝
争强赌胜	爭強賭勝
争斗	爭鬥
争斗不休	爭鬥不休
争相罗致	爭相羅致
争红斗紫	爭紅鬥紫
争胜	爭勝
争胜要强	爭勝要強
争闲气	爭閒氣
争面子	爭面子
事与愿违	事與願違
事也干	事也幹
事出	事出
事出不意	事出不意
事出不测	事出不測
事出有因	事出有因
事前事后	事前事後
事发	事發
事发地点	事發地點
事发时	事發時
事可干	事可幹
事后	事後
事后聪明	事後聰明
事后诸葛亮	事後諸葛亮
事好干	事好幹
事实胜于雄辩	事實勝於雄辯
事干	事幹
事态发展	事態發展
事情可干	事情可幹
事情好干	事情好幹
事情干脆	事情干脆
事成之后	事成之後
事有斗巧	事有鬥巧
事迹	事蹟
二丁挂	二丁掛
二仑	二崙
二仑乡	二崙鄉
二价	二價
二余	二餘
二党制	二黨制
二六板	二六板
二冲程引擎	二衝程引擎
二出祁山	二出祁山
二分钟	二分鐘
二划	二劃
二叠系	二疊系
二口虫	二口蟲
二只	二隻
二台	二臺
二叶松	二葉松
二合一	二合一
二吊六	二吊六
二周	二週
二和药	二和藥
二回	二回
二回熟	二回熟
二堂舍子	二堂舍子
二天后	二天後
二姑娘顽老雕	二姑娘頑老雕
二娘	二孃 二娘
二娘子	二娘子
二屋里	二屋裏
二年制	二年制
二弦	二絃
二志	二志
二恶英	二噁英
二手烟	二手菸
二拉八当	二拉八當
二撇胡	二撇鬍
二斗	二斗
二杆子	二桿子
二杯	二杯
二板	二板
二极	二極
二极体	二極體
二极管	二極管
二柜	二櫃
二次曲	二次曲
二次曲线	二次曲線
二次曲面	二次曲面
二段制	二段制
二流人才	二流人才
二点钟	二點鐘
二班制	二班制
二田制	二田制
二百万	二百萬
二百个	二百個
二百多万	二百多萬
二种	二種
二秒钟	二秒鐘
二缶钟惑	二缶鐘惑
二老板	二老闆
二胡	二胡
二致	二致
二苏	二蘇
二虎相斗	二虎相鬥
二表哥	二表哥
二表妹	二表妹
二表姊	二表姊
二表姊夫	二表姊夫
二表姐	二表姐
二表嫂	二表嫂
二表弟	二表弟
二进位制	二進位制
二进制	二進制
二部制	二部制
二部合唱	二部合唱
二部曲	二部曲
二里	二里
二里头	二里頭
二里头文化	二里頭文化
二重分类表	二重分類表
二门不出	二門不出
二面角	二面角
二项式系数	二項式係數
于一	於一
于一役	於一役
于七	於七
于三	於三
于丑	於醜
于世	於世
于丹	于丹
于之	於之
于乎	於乎
于乐	於樂
于九	於九
于事	於事
于事无济	於事無濟
于事无补	於事無補
于二	於二
于于	于于
于五	於五
于人	於人
于仁泰	于仁泰
于今	於今
于今犹烈	於今猶烈
于从濂	于從濂
于他	於他
于伏	於伏
于会泳	于會泳
于伟国	于偉國
于何	於何
于余曲折	于餘曲折
于你	於你
于佳卉	于佳卉
于光远	于光遠
于克勒	于克勒
于八	於八
于六	於六
于冕	于冕
于军	于軍
于农	於農
于凌奎	于凌奎
于凤桐	于鳳桐
于凤至	于鳳至
于前	於前
于劣	於劣
于勒	于勒
于勤	於勤
于化虎	于化虎
于十	於十
于半	於半
于占元	于占元
于双戈	于雙戈
于台烟	于臺煙
于右任	于右任
于吉	于吉
于后	於後
于呼哀哉	於呼哀哉
于品海	于品海
于嗟	于嗟
于四	於四
于国	於國
于国桢	于國楨
于坚	于堅
于垂	於垂
于堅	于堅
于墙	於牆
于大宝	于大寶
于天仁	于天仁
于夫罗	於夫羅
于奇库杜克	于奇庫杜克
于她	於她
于好	於好
于始	於始
于姓	于姓
于娜	于娜
于娟	于娟
于子千	于子千
于孔兼	于孔兼
于学忠	于學忠
于它	於它
于家	於家
于家为国	於家爲國
于家堡	于家堡
于密	於密
于寘	于寘
于小伟	于小偉
于小彤	于小彤
于尔岑	于爾岑
于尔根	于爾根
于尔里克	于爾里克
于尽	於盡
于山	于山
于山国	于山國
于左	於左
于差	於差
于己	於己
于市	於市
于帅	于帥
于帥	于帥
于幕	於幕
于幼军	于幼軍
于幼华	於幼華
于广洲	于廣洲
于康震	于康震
于式枚	于式枚
于弱	於弱
于强	於強
于归	于歸
于征	於徵
于徐	于徐
于從濂	于從濂
于德海	于德海
于心	於心
于心不安	於心不安
于心不忍	於心不忍
于心何忍	於心何忍
于心无愧	於心無愧
于志宁	于志寧
于怀	於懷
于思	于思
于慎行	于慎行
于慧	于慧
于戏	於戲
于成龍	于成龍
于成龙	于成龍
于我	於我
于振	于振
于振武	于振武
于敏	于敏
于敏中	于敏中
于敝	於敝
于斌	于斌
于斯	於斯
于斯塔德	于斯塔德
于斯納爾斯貝里	于斯納爾斯貝里
于斯纳尔斯贝里	于斯納爾斯貝里
于斯达尔	于斯達爾
于斯達爾	于斯達爾
于时	於時
于明涛	于明濤
于是	於是
于是之	於是之
于是乎	於是乎
于是就	於是就
于晨楠	于晨楠
于晴	于晴
于杰	于傑
于树洁	于樹潔
于根伟	于根偉
于格	于格
于梨华	於梨華
于樂	于樂
于欣源	于欣源
于正升	于正昇
于正昌	于正昌
于此	於此
于毕	於畢
于民	於民
于民润国	於民潤國
于水	於水
于永波	于永波
于汉超	于漢超
于江震	于江震
于法	於法
于法无据	於法無據
于波	于波
于泽尔	于澤爾
于洪区	于洪區
于浩威	于浩威
于海洋	于海洋
于涛	于濤
于湘兰	于湘蘭
于潜县	於潛縣
于濤	于濤
于火	於火
于焉	於焉
于爾里克	于爾里克
于物	於物
于特森	于特森
于玉立	于玉立
于田	于田
于田县	于田縣
于盲	於盲
于祂	於祂
于禁	于禁
于秀敏	于秀敏
于穆	於穆
于素秋	于素秋
于终	於終
于美	於美
于美人	於美人
于色	於色
于若木	于若木
于荫霖	于蔭霖
于菟	於菟
于蓝	於藍
于行	於行
于衡	于衡
于衷	於衷
于西翰	于西翰
于謙	于謙
于该	於該
于谦	于謙
于贈	于贈
于贝尔	于貝爾
于赠	于贈
于越	于越
于軍	于軍
于过	於過
于远伟	于遠偉
于途	於途
于道泉	于道泉
于邑	於邑
于都县	於都縣
于里察	于里察
于野	於野
于阗	于闐
于陆	於陸
于雾霭之中	於霧靄之中
于震寰	于震寰
于震环	于震環
于靖	于靖
于韋斯屈萊	于韋斯屈萊
于韦斯屈莱	于韋斯屈萊
于风政	于風政
于飞	于飛
于飞之乐	于飛之樂
于馀曲折	于餘曲折
于默奥	于默奧
亏不尽	虧不盡
亏了	虧了
亏折	虧折
亏本出售	虧本出售
云中	雲中
云中君	雲中君
云中白鹤	雲中白鶴
云为	云爲
云乎	云乎
云云	云云
云从龙风从虎	雲從龍風從虎
云仙杂记	雲仙雜記
云何	云何
云儿	雲兒
云兴霞蔚	雲興霞蔚
云冈	雲岡
云冈石佛	雲岡石佛
云冈石窟